00TTTTTTTTTTTTTTTTTTTT
01TTT............TTTT.
02TT.............TTT..
03T...................
04T...................
05T...................
06T...................
07T...................
08T...................
09T...................
10T...................
11T...................
12T...................
13T...................
14T...................
15TTT............TTTT.
16TTT............TTTT.
17TTT............TTTT.
18TT.............TTT..
19TT..................