TTTTTTTTTTTTTTT
TTT............
TT.............
T..............
T..............
T..............
T..............
T..............
T..............
T..............
T..............
T..............
T..............
T..............
T..............