TTTTTTTTTTTTTTTTTTTT
TTT............TTTT.
TT.............TTT..
T...................
T...................
T...................
T...................
T...................
T...................
T...................
T...................
T...................
T...................
T...................
T...................
TTT............TTTT.
TTT............TTTT.
TTT............TTTT.
TT.............TTT..
TT..................
